21100000000000000000
00111111111100000000
00100010000111111100
01100010000000000100
01000011110001111100
01000000001111000000
01100000001000000000
00100000001111111000
00001110000000001000
01111011111111111000
01000000000000000000
01111100111111100000
00000111100000111110
01111100000000000010
01000000001111111110
01111110011000000000
00000010010000000000
01111110011111000000
01000000000001100000
11000000000000111113
